19,21,25,25
0,0,0,0,0,0,0,0,0,0,0,0,0,0,0,0,0,0,0
0,1,1,1,1,1,1,1,1,0,1,1,1,1,1,1,1,1,0
0,0,0,0,1,0,0,0,1,0,1,0,0,0,1,0,0,0,0
0,1,1,1,1,1,1,1,1,1,1,1,1,1,1,1,1,1,0
0,1,0,0,1,0,1,0,0,0,0,0,1,0,1,0,0,1,0
0,1,1,1,1,0,1,1,1,0,1,1,1,0,1,1,1,1,0
0,0,0,0,1,0,0,0,0,0,1,0,0,0,1,0,0,0,0
1,1,1,0,1,0,1,1,1,1,1,1,1,0,1,0,1,1,1
0,0,0,0,1,0,1,0,0,0,0,0,1,0,0,0,0,0,0
0,1,1,1,1,0,1,0,1,1,1,0,1,0,1,1,1,1,0
0,0,0,0,1,0,1,0,0,0,0,0,1,0,1,0,0,0,0
1,1,1,0,1,0,1,1,1,1,1,1,1,0,1,0,1,1,1
0,0,0,0,1,0,1,0,0,0,0,0,1,0,1,0,0,0,0
0,1,1,1,1,1,1,1,1,0,1,1,1,1,1,1,1,1,0
0,1,0,0,1,0,0,0,1,0,1,0,0,0,1,0,0,1,0
0,1,1,0,1,1,1,1,1,1,1,1,1,1,1,0,1,1,0
0,1,1,0,1,0,1,0,0,0,0,0,1,0,0,0,1,1,0
0,1,1,0,1,0,1,1,1,0,1,1,1,0,1,1,1,1,0
0,1,0,0,0,0,0,0,1,0,0,0,0,0,0,0,0,0,0
0,1,1,1,1,1,1,1,1,1,1,1,1,1,1,1,1,1,0
0,0,0,0,0,0,0,0,0,0,0,0,0,0,0,0,0,0,0

Stages
SCATTER,5
CHASE,20
SCATTER,5
CHASE,20
SCATTER,5
CHASE,-1